111111111
1P000C0E1
111111111
